حمل و نقل	حمل‌و‌نقل
می توانیم	می‌توانیم
روشها	روش‌ها
فناری	فناوری
رایکهزار	را یک‌هزار
ورودیهای	ورودی‌های
طرحها	طرح‌ها
مهمترین	مهم‌ترین
راههایی	راه‌هایی
مهارتهای	مهارت‌های
ارایه	ارائه
درمانهای	درمان‌های
در حالیکه	در حالی که
حالی‌که	حالی که
سالهای	سال‌های
آسیبها	آسیب‌ها
تصمیمگیریها	تصمیم‌گیری‌ها
دانشگاهها	دانشگاه‌ها
دولتها	دولت‌ها
حساسیتهای	حساسیت‌های
عصیانگریها	عصیانگری‌ها
هنجارشکنیها	هنجارشکنی‌ها
پرخاشگریها	پرخاشگری‌ها
مدیریتها	مدیریت‌ها
میلیونها	میلیون‌ها
ارزشها	ارزش‌ها
هم اکنون	هم‌اکنون
ژاپنیها	ژا‌پنی‌ها
کوهها	کوه‌ها
مسوولان	مسئولان
واکنشها	واکنش‌ها
خواستها	خواست‌ها
فعالیتها	فعالیت‌ها
رنگها	رنگ‌ها
قیمتها	قیمت‌ها
مسایل	مسائل
آنکه	آن که
سیاستها	سیاست‌ها
جاییکه	جایی که
جبران پذیر	جبران‌پذیر
پیگیریها	پیگیری‌ها
شهرداریها	شهرداری‌ها
نارساییها	نارسایی‌ها
آپارتمانها	آپارتمان‌ها
مسوولین	مسئولین
بیت المقدس	بیت‌المقدس
اطاق	اتاق
اطو	اتو
امپراطور	امپراتور
ذغال	زغال
غلت	غلط
قاطی	قاتی
استدلالها	استدلال‌ها
بررسیها	بررسی‌ها
صحبتها	صحبت‌ها
اینها	این‌ها
این ها	این‌ها
آن ها	آن‌ها
آنها	آن‌ها
عن قریب	عن‌قریب
مطمینا	مطمئنا
مطمین	مطمئن
مسیله	مسئله
اینگونه	این‌گونه
آنگونه	این‌گونه
آنگونه	آن‌گونه
آن گونه	آن‌گونه
بفروشها	بفروش‌ها
اینجا	این‌جا
این جا	این‌جا
اینجا	این‌جا
آنجا	آن‌جا
آن جا	آن‌جا
مالیاتها	مالیات‌ها
همچنانکه	هم‌چنان‌که
سازمانها	سازمان‌ها
دستگاهها	دستگاه‌ها
مسوول	مسئول
مسیولیت	مسئولیت
ناهنجاریها	ناهنجاری‌ها
روان شناختی	روان‌شناختی
ایدیولوژی	ایدئولوژی
مستند سازی	مستندسازی
برنامه ریزی	برنامه‌ریزی
روش شناسی	روش‌شناسی
گرفته ایم	گرفته‌ایم
ویژگی ها	ویژگی‌ها
تحویل ها	تحویل‌ها
دانشکده ها	دانشکده‌ها
پرسش ها	پرسش‌ها
گزارش ها	گزارش‌ها
نقد ها	نقد‌ها
شهر ها	شهر‌ها
بخش ها	بخش‌ها
نسبت ها	نسبت‌ها
لکه ها	لکه‌ها
جامعه ها	جامعه‌ها
ده ها	ده‌ها
پتانسیل ها	پتانسیل‌ها
بحث ها	بحث‌ها
اضطرار ها	اضطرار‌ها
پروژه ها	پروژه‌ها
اتوبوس ها	اتوبوس‌ها
دغدغه ها	دغدغه‌ها
روش‌ها	روش‌ها
هماهنگی ها	هماهنگی‌ها
تلاش ها	تلاش‌ها
ایستگاه ها	ایستگاه‌ها
برنامه ها	برنامه‌ها
کارت ها	کارت‌ها
اتوبس ها	اتوبوس‌ها
ظرفیت ها	ظرفیت‌ها
رده ها	رده‌ها
واگن ها	واگن‌ها
تکنولوژی ها	تکنولوژی‌ها
دریچه ها	دریچه‌ها
تماس ها	تماس‌ها
مخزن ها	مخزن‌ها
زباله ها	زباله‌ها
تونل ها	تونل‌ها
خانواده ها	خانواده‌ها
قسمت ها	قسمت‌ها
شکل ها	شکل‌ها
مقاله ها	مقاله‌ها
دین ها	دین‌ها
خستگی ها	خستگی‌ها
کشمکش ها	کشمکش‌ها
توهین ها	توهین‌ها
سنی ها	سنی‌ها
انسان ها	انسان‌ها
اقلیت ها	اقلیت‌ها
راه حل ها	راه‌حل‌ها
صهیونیست ها	صهیونیست‌ها
کشور ها	کشور‌ها
ریش ها	ریش‌ها
کنفرانس ها	کنفرانس‌ها
نقشه ها	نقشه‌ها
بچه ها	بچه‌ها
سال ها‌	یچه‌ها
کمونیست ها	کمونیست‌ها
قانون ها‌	قانون‌ها
افراط ها	افراط‌ها
سال ها	سال‌ها
دروغ گویی ها	دروغ‌گویی‌ها
رسانه ها	رسانه‌ها
دروغ ها	دروغ‌ها
رژیم ها	رژیم‌ها
فلسطینی ها	فلسطینی‌ها
خانه ها	خانه‌ها
گفته ها	گفته‌ها
یهودی ها	یهودی‌ها
پروتستان ها	پروتستان‌ها
کشیش ها	کشیش‌ها
آیه ها	آیه‌ها
سرزمین ها	سرزمین‌ها
درگیری ها	درگیری‌ها
زمینه ها	زمینه‌ها
برنامه ریزی ها	برنامه‌ریزی‌ها
حمایت ها	حمایت‌ها
رشته ها	رشته‌ها
خوبی ها	خوبی‌ها
فرصت ها	فرصت‌ها
انگیزش ها	انگیزش‌ها
بنگاه ها	بنگاه‌ها
مزیت ها	مزیت‌‌ها
نهاده ها	نهاده‌ها
شبکه ها	شبکه‌ها
حوزه ها	حوزه‌ها
شرکت ها	شرکت‌ها
ناکارآمدی ها	ناکارآمدی‌ها
نامطمئنی ها	نامطمئنی‌ها
هزینه ها	هزینه‌ها
ریسک ها	ریسک‌ها
دخالت ها	دخالت‌ها
قابلیت ها	قابلیت‌ها
دولت ها	دولت‌ها
نابسامانی ها	نابسامانی‌ها
بودجه ها	بودجه‌ها
پشتوانه ها	پشتوانه‌ها
سرخوردگی ها	سرخوردگی‌ها
بی عدالتی ها	بی‌عدالتی‌ها
وعده ها	وعده‌ها
آسیب ها	آسیب‌ها
شعار ها	شعار‌ها
تشکل ها	تشکل‌ها
گروه ها	گروه‌ها
سرمایه ها	سرمایه‌ها
رویه ها	رویه‌ها
دارایی ها	دارایی‌ها
مخالفت ها	مخالفت‌ها
سازمان ها	سازمان‌ها
رویه ها	رویه‌ها
استان ها	استان‌ها
فرصت ها	فرصت‌ها
تصمیم ها	تصمیم‌ها
قانونمندی ها	قانون‌مندی‌ها
نامه ها	نامه‌ها
دل نگرانی ها	دل‌نگرانی‌ها
نگرانی ها	نگرانی‌ها
نامه ها	نامه‌ها
ثروت ها	ثروت‌ها
صندوق ها	صندوق‌ها
دستورالعمل ها	دستورالعمل‌ها
سپرده ها	سپرده‌ها
چک ها	چک‌ها
رتبه ها	رتبه‌ها
دوره ها	دوره‌ها
ردیف ها	ردیف‌ها
فوق العاده ها	فوق‌العاده‌ها
دوره ها	دوره‌ها
پرداختی ها	پرداختی‌ها
یارانه ها	یارانه‌ها
قبض ها	قبض‌ها
سرکوب ها	سرکوب‌ها
حرکت ها	حرکت‌ها
تریبون ها	تریبون‌ها
تخلف ها	تخلف‌ها
دستاورد ها	دستاورد‌ها
سده ها	سده‌ها
تمدن‌ها	تمدن‌ها
فرهنگ ها	فرهنگ‌ها
عظمت ها	عظمت‌ها
کشاکش ها	کشاکش‌ها
طوفان ها	طوفان‌ها
غارت ها	غارت‌ها
گشتن ها	گشتن‌ها
آموزش ها	آموزش‌ها
ملت ها	ملت‌ها
جنگ ها	جنگ‌ها
ایرانی ها	ایرانی‌ها
قومیت ها	قومیت‌ها
تهاجم ها	تهاجم‌ها
حکومت ها	حکومت‌ها
پیشرفت ها	پیشرفت‌ها
جنبه ها	جنبه‌ها
قدرت ها	قدرت‌ها
اندیشه ها	اندیشه‌ها
غربی ها	غربی‌ها
ریشه ها	ریشه‌ّها
مایه ها	مایه‌ها
بینش ها	بینش‌ها
زمزمه ها	زمزمه‌ها
حرف ها	حرف‌ها
دوگانگی ها	دوگانگی‌ها
روزنامه ها	روزنامه‌ها
رسانه ها	رسانه‌ها
حداقل ها	حداقل‌ها
جریان ها	جریان‌ها
ایده ها	ایده‌ها
ماهیچه ها	ماهیچه‌ها
میدان ها	میدان‌ها
سیستم‌ها	سیستم‌ها
توصیه ها	توصیه‌ها
احتیاط ها	احتیاط‌ها
تلفن ها	تلفن‌ها
گوشی ها	گوشی‌ها
فرکانس ها	فرکانس‌ها
پالس ها	پالس‌ها
مکانیزم ها	مکانیزم‌ها
سلول ها	سلول‌ها
دام ها	دام‌ها
بزغاله ها	بزغاله‌ها
مدت ها	مدت‌ها
لخته ها	لخته‌ها
سکته ها	سکته‌ها
پروتیین ها	پروتئین‌ها
گزینه ها	گزینه‌ها
تمرین ها	تمرین‌ها
پرتاب ها	پرتاب‌ها
پاکت ها	پاکت ها
کتاب ها	کتاب‌ها
ورزش ها	ورزش‌ها
لباس ها	لباس‌ها
محل ها	محل‌ها
الیاف ها	الیاف‌ها
اندام ها	اندام‌ها
سامانه ها	سامانه‌ها
قطب ها	قطب‌ها
واژه ها	واژه‌ها
تفریط ها	تفریط‌ها
راه ها	راه‌ها
نیمه ها	نیمه‌ها
شیرازی ها	شیرازی‌ها
مهره ها	مهره‌ها
بازی ها	بازی‌ها
بدشانسی ها	بدشانسی‌ها
سه کارته ها	سه‌کارته‌ها
محروم ها	محروم‌ها
باشگاه ها	باشگاه‌ها
فوتبالیست ها	فوتبالیست‌ها
تیم ها	تیم‌ها
بعضی ها	بعضی‌ها
کمیته ها	کمیته‌ها
کارگاه ها	کارگاه‌ها
استادیوم ها	استادیوم‌ها
برگزاری ها	برگزاری‌ها
سابقه ها	سابقه‌ها
رایزنی ها	رایزنی‌ها
خبرگزاری ها	خبرگزاری‌ها
می باشد	می‌باشد
می توانیم‌	می‌توانیم
علایم	علائم
می توان	می‌توان
می کند	می‌کند
می کنم	می‌کنم
می کنیم	می‌کنیم
می کنید	می‌کنید
می کنند	می‌کنند
می کنی	می‌کنی
می شوم	می‌شوم
می شوی	می‌شوی
می شود	می‌شود
می شویم	می‌شویم
می شوید	می‌شوید
می شود‌	می‌شود
می شوند	می‌شوند
می گفت	می‌گفت
می گوید‌	می‌گوید
می گفتم	می‌گفتم
می گویم	می‌گویم
می پردازد	‌می‌پردازد
می خوانید	می‌خوانید
می دهم	می‌دهم
می دهی	می‌دهی
می دهد	می‌دهد
می دهیم	می‌دهیم
می دهید	می‌دهید
می دهند	می‌دهند
می کردم	می‌کردم
می کردی	می‌کردی
می کرد	می‌کردم
می‌کردیم	می‌کردیم
می‌کردید	می‌کردید
می‌کردند	می‌کردند
می دانیم	می‌دانیم
می گرفت	می‌گرفت
می گرفتم	می‌گرفتم
می گرفتی	می‌گرفتی
می گرفتیم	می‌گرفتیم
می گرفتید	می‌گرفتید
می گرفتند	می‌گرفتند
می گیرم	می‌گیرم
می گیری	می‌گیری
می گیرد	می‌گیرد
می گیریم	می‌گیریم
می گیرید	می‌گیرید
می گیرند	می‌گیرند
می دادم	می‌دادم
می داد	می‌داد
می دادی	می‌دادی
می دادیم	می‌دادیم
می دادید	می‌دادید
می دادند	می‌دادند
می شدم	می‌شدم
می‌شدی	می‌شدی
می شد	می‌شد
می شدیم	می‌شدیم
می شدید	می‌شدید
می شدند	می‌شدند
می کشاند	می‌کشاند
می آیم	می‌آیم
می آیی	می‌آیی
می آید	می‌آید
می آییم	می‌آییم
می آیید	می‌آیید
می آیند	می‌آیند
دایم	دائم
می گذراند	می‌گذراند
می گذرانند	می‌گذرانند
می کوشند	می‌کوشند
می رسم	می‌رسم
می رسی	می‌رسی
می رسد	می‌رسد
می رسیم	می‌رسیم
می رسید	می‌رسید
می‌رسند	می‌رسند
می گذارد	می‌گذارد
می گذارم	می‌گذارم
می گذارند	می‌گذارند
می گذاشتم	می‌گذاشتم